’ BX1V‚‹ De vocabulis Ichneutarum. 7

 

 

 

λόχμη —.Homerus. Ρ*πλάνη - Aeschylus.
μάλθη —— Hipponax. πνίγειν - Epicharmus.
*μήνυτρον - Hymnus Hom. in. πρεσβύτης —— Aeschylus.
Mercurium. πρόσπαιος - Aeschylus.
*μήτρως - Homerus. προσφερής — Aeschylus,
*μόσχις — Homerus. . ποίγων - Anacreon.
ρπλή -— Homerus. σχολάζεσθαι — Aeschylus.
παιδια· —— Aeschylus. Ρ*τορῶς - Aeschylus.
παραμένειν -— Homerus. φαλακρός -— Anacreon.

 

πίθηκος 1- Archilochus.

πλάγιος —- Pindarus. 39 (*8)·

B. Vocabula a scriptoribus Sophocli aequalibus vel recentioribus
classicae aetatis usurpata:

 

?*a³ya6vn3; —- Xenophon. πατρικάς - Cratinus.
ἀπελεύθερος - Xenophon. πέλεθος —- Aristophanes.
αὐτόχρημα —— Aristophanes. προμήκης —- Plato.
βριιχυσκελὴς - Aristoteles. ’ προσβιβάζειν — Aristophanes.
γειτνιᾶν — Aristophanes. σύλησις - Plato.

γελοῖος —- Xenophon. τάγμα - Xenophon.
*ἐξοργίζεσθαι - Xenophon. ὂ ὕ, 1‘1' ὖ — Aristophanes.
Ρ*ἴτης -— Plato. ὑλώδης - Thucydides.
ἰχνευτής -- Herodotus. ὑπόνομος — Thucydides.
,κνηιιόςι - Theocritus. ὕποσμος — Aristoteles.
κόλαξ — Eupolis. ὖφορᾶν — Euripides.
λα’θριος - Plato comicus. φαλῆς — Aristophanes.
*λοπάς — Poetae comici. *φώρ - Herodotus.

⁴? *νεανίευμα - Plato.

*ὄστρεον - Plato. 28 (²⁸7)

C. Vocabula‚ quorum usum scriptores aetatis Hellenisticae vel
etiam posteriores indicant:

διαχαράσσεσθαι — Plutarchus.
καταρρικνοῦν —— Gregorius Nyssensis.

